11111111111
100P0011E01
1011000C001
10000110001
11111111111
