111111111
1CCPCCEC1
1CCCCCC 1
1CCCCCCC1
1CCCCCCC1
111111111
