111111111111111111
1P00000000C0000011
101110000011111111
101E10000000000001
111111111111111111
