1111111111
1000000010
1E00C00P10
1111111111
