1111111111111111111
100PC011E0000000001
1011000000000000001
1000011000000000001
1111111111111111111
