111111111
100P00E01
10000C001
100000001
111111111