11111111111
111P1111E11
111111C1111
11111111111
11111111111
