111111111
111P00EC1
11111C111
111111111
111111111
